"Origin","Carrier","CarrierDelay","WeatherDelay","NASDelay","SecurityDelay","LateAircraftDelay","TotalDelay"
"ABE","DL",41,0,172,0,0,213
"ABE","EV",119,0,183,0,47,349
"ABE","OO",42,0,22,0,10,74
"ABI","EV",0,0,3,0,145,148
"ABQ","AA",502,0,77,0,65,644
"ABQ","AS",0,0,50,0,319,369
"ABQ","B6",50,0,46,0,53,149
"ABQ","DL",1241,0,27,0,0,1268
"ABQ","EV",23,0,58,0,254,335
"ABQ","OO",0,0,218,0,667,885
"ABQ","UA",43,0,142,0,483,668
"ABQ","WN",863,131,1436,0,2970,5400
"ABR","OO",0,0,0,0,63,63
"ABY","EV",907,0,34,0,1004,1945
"ACT","EV",510,0,79,0,191,780
"ACV","OO",1516,0,1167,0,564,3247
"ACY","NK",1267,51,830,0,720,2868
"ADK","AS",0,0,17,0,14,31
"ADQ","AS",1,0,0,44,76,121
"AEX","EV",1436,0,180,0,1006,2622
"AGS","DL",361,0,124,0,0,485
"AGS","EV",36,0,48,0,1015,1099
"AGS","OO",345,0,2,0,320,667
"ALB","AA",110,0,27,0,605,742
"ALB","B6",31,0,116,0,151,298
"ALB","DL",600,140,73,0,74,887
"ALB","EV",0,0,9,0,42,51
"ALB","OO",764,201,59,0,383,1407
"ALB","UA",156,127,154,0,0,437
"ALB","WN",335,374,1165,0,787,2661
"AMA","AA",768,3,89,0,0,860
"AMA","EV",0,0,150,0,72,222
"AMA","WN",51,0,5,0,200,256
"ANC","AS",2023,1003,2312,0,2510,7848
"ANC","DL",1150,0,90,0,206,1446
"ANC","UA",41,0,63,0,0,104
"APN","OO",45,25,32,0,425,527
"ASE","OO",2993,535,3873,24,6513,13938
"ATL","AA",1872,74,2122,0,1729,5797
"ATL","AS",81,0,275,0,189,545
"ATL","DL",29750,1312,24619,0,6006,61687
"ATL","EV",31304,0,1420,0,10068,42792
"ATL","F9",200,0,544,0,873,1617
"ATL","NK",980,0,1834,0,3119,5933
"ATL","OO",6335,0,667,0,4213,11215
"ATL","UA",273,0,3045,0,1783,5101
"ATL","WN",5221,682,4304,0,5571,15778
"ATW","DL",50,0,213,0,0,263
"ATW","EV",7,0,43,0,208,258
"ATW","OO",309,0,76,0,312,697
"AUS","AA",1123,0,1380,0,1264,3767
"AUS","AS",25,0,109,0,190,324
"AUS","B6",1156,0,399,0,966,2521
"AUS","DL",1015,0,559,0,131,1705
"AUS","F9",90,0,250,0,31,371
"AUS","OO",923,125,1493,0,917,3458
"AUS","UA",797,0,1182,0,2041,4020
"AUS","VX",82,35,407,0,159,683
"AUS","WN",2079,535,2832,0,3147,8593
"AVL","DL",0,0,17,0,5,22
"AVL","EV",201,0,32,0,816,1049
"AVL","OO",906,0,119,0,69,1094
"AVL","UA",10,0,172,0,546,728
"AVP","DL",244,0,68,0,0,312
"AVP","EV",0,0,169,0,87,256
"AVP","OO",126,735,64,0,138,1063
"AZO","EV",659,360,195,0,384,1598
"AZO","OO",153,201,52,0,624,1030
"BDL","AA",417,72,614,0,1160,2263
"BDL","B6",941,39,341,0,2006,3327
"BDL","DL",321,926,599,0,192,2038
"BDL","EV",29,0,23,0,0,52
"BDL","OO",0,0,44,0,0,44
"BDL","UA",86,25,165,0,122,398
"BDL","WN",1476,215,1105,0,841,3637
"BET","AS",17,0,7,17,146,187
"BFL","OO",351,0,71,0,230,652
"BGM","OO",22,260,101,0,215,598
"BHM","DL",2163,15,242,0,824,3244
"BHM","EV",1938,0,432,0,898,3268
"BHM","WN",137,264,186,19,686,1292
"BIL","DL",39,0,119,0,0,158
"BIL","OO",0,2,208,0,418,628
"BIL","UA",68,0,158,0,112,338
"BIS","DL",183,23,42,0,0,248
"BIS","OO",0,0,35,0,229,264
"BJI","OO",18,44,265,5,89,421
"BLI","AS",251,205,252,0,724,1432
"BMI","DL",127,0,1,0,0,128
"BMI","EV",176,0,76,0,12,264
"BMI","OO",0,1,44,0,202,247
"BNA","AA",1586,0,1142,0,542,3270
"BNA","AS",21,0,94,0,138,253
"BNA","B6",77,0,77,0,416,570
"BNA","DL",170,109,542,0,504,1325
"BNA","EV",67,0,1189,0,1173,2429
"BNA","F9",204,0,264,0,125,593
"BNA","OO",2261,520,394,0,746,3921
"BNA","UA",62,0,1050,0,83,1195
"BNA","WN",2437,492,2543,0,5755,11227
"BOI","AA",1031,0,46,0,0,1077
"BOI","DL",0,0,30,0,16,46
"BOI","OO",3042,445,2308,0,1941,7736
"BOI","UA",54,0,23,0,108,185
"BOI","WN",739,27,403,0,1269,2438
"BOS","AA",4399,146,5975,22,2855,13397
"BOS","AS",69,16,501,0,965,1551
"BOS","B6",15791,918,15960,226,13631,46526
"BOS","DL",3220,3834,3866,0,4589,15509
"BOS","EV",429,0,100,0,1045,1574
"BOS","NK",1307,89,1719,0,1615,4730
"BOS","UA",1888,227,6708,0,2565,11388
"BOS","VX",668,962,1348,0,599,3577
"BOS","WN",1101,485,1632,0,860,4078
"BQK","EV",143,0,43,0,443,629
"BQN","B6",40,0,35,0,465,540
"BQN","NK",9,0,62,0,0,71
"BQN","UA",6,464,90,0,189,749
"BRD","OO",20,108,37,7,0,172
"BRO","EV",0,0,15,0,252,267
"BRW","AS",43,35,16,0,773,867
"BTM","OO",137,66,19,0,16,238
"BTR","DL",10,0,10,0,154,174
"BTR","EV",4811,866,363,0,893,6933
"BTR","UA",29,0,0,0,177,206
"BTV","B6",66,0,165,0,488,719
"BTV","EV",221,6,1462,0,733,2422
"BTV","UA",43,0,0,0,234,277
"BUF","AA",46,11,32,0,61,150
"BUF","B6",582,0,814,0,1355,2751
"BUF","DL",887,16,17,0,8,928
"BUF","EV",455,0,397,0,178,1030
"BUF","OO",3,0,479,0,338,820
"BUF","WN",1550,44,659,0,452,2705
"BUR","AS",376,158,101,0,469,1104
"BUR","B6",12,0,33,0,0,45
"BUR","OO",1608,255,2789,0,1559,6211
"BUR","UA",83,0,95,0,310,488
"BUR","WN",1066,58,2405,0,6303,9832
"BWI","AA",1220,0,504,0,1421,3145
"BWI","AS",421,110,289,0,73,893
"BWI","B6",681,480,509,0,968,2638
"BWI","DL",624,83,178,0,300,1185
"BWI","EV",5,0,190,0,160,355
"BWI","NK",720,0,2125,0,2105,4950
"BWI","UA",656,0,181,0,549,1386
"BWI","WN",9489,1148,6271,53,8706,25667
"BZN","DL",5,0,57,0,26,88
"BZN","OO",1064,0,1137,0,541,2742
"BZN","UA",164,0,110,0,189,463
"CAE","DL",389,5,76,0,48,518
"CAE","EV",942,0,355,0,620,1917
"CAK","DL",118,0,0,0,0,118
"CAK","EV",36,0,1026,0,738,1800
"CAK","NK",353,0,210,0,55,618
"CAK","OO",18,0,142,0,305,465
"CAK","WN",394,0,29,0,148,571
"CDC","OO",0,0,110,0,54,164
"CDV","AS",62,0,67,0,774,903
"CHA","DL",610,0,0,0,0,610
"CHA","EV",274,0,1430,0,1015,2719
"CHA","OO",1772,0,89,0,401,2262
"CHO","DL",22,0,0,0,0,22
"CHO","EV",15,0,38,0,107,160
"CHO","OO",1662,0,395,0,1305,3362
"CHS","AA",12,0,60,0,102,174
"CHS","AS",0,0,47,0,46,93
"CHS","B6",322,104,549,0,275,1250
"CHS","DL",264,0,160,0,170,594
"CHS","EV",203,0,835,0,863,1901
"CHS","OO",127,0,66,0,126,319
"CHS","WN",32,80,55,0,198,365
"CID","DL",35,34,20,0,0,89
"CID","EV",32,0,39,0,935,1006
"CID","OO",879,0,211,0,497,1587
"CIU","OO",1,43,90,0,110,244
"CLE","AA",97,0,101,0,518,716
"CLE","B6",373,0,187,0,364,924
"CLE","DL",71,0,0,0,138,209
"CLE","EV",2682,0,2288,0,2470,7440
"CLE","F9",234,0,364,0,310,908
"CLE","NK",437,119,1138,0,584,2278
"CLE","OO",0,0,23,0,240,263
"CLE","UA",950,0,1912,0,518,3380
"CLE","WN",814,67,688,0,483,2052
"CLL","EV",0,82,19,0,138,239
"CLT","AA",13588,615,16143,130,11975,42451
"CLT","B6",278,0,357,0,1158,1793
"CLT","DL",538,0,305,0,569,1412
"CLT","EV",1343,0,412,0,440,2195
"CLT","F9",180,0,109,0,378,667
"CLT","OO",110,1043,435,0,457,2045
"CLT","UA",0,0,180,0,8,188
"CLT","WN",516,0,87,0,300,903
"CMH","AA",231,0,279,0,542,1052
"CMH","DL",189,0,207,0,648,1044
"CMH","EV",85,0,1992,0,1354,3431
"CMH","F9",221,0,196,0,48,465
"CMH","OO",1,0,5,0,54,60
"CMH","UA",244,0,62,0,557,863
"CMH","WN",1078,71,866,0,1839,3854
"CMX","OO",259,186,21,15,271,752
"COD","OO",2,0,74,0,386,462
"COS","AA",1475,30,67,0,122,1694
"COS","DL",0,16,0,0,0,16
"COS","EV",42,0,20,0,275,337
"COS","F9",88,41,254,0,1041,1424
"COS","OO",3454,280,1539,0,833,6106
"CPR","OO",205,0,0,0,105,310
"CRP","EV",3,60,297,0,523,883
"CRP","WN",10,56,445,0,251,762
"CRW","DL",110,0,31,0,0,141
"CRW","EV",868,0,66,0,819,1753
"CSG","EV",211,0,75,0,415,701
"CVG","DL",1370,535,941,0,469,3315
"CVG","F9",196,69,518,0,426,1209
"CVG","OO",1111,201,283,0,2327,3922
"CVG","UA",0,96,442,0,0,538
"CWA","EV",0,0,11,0,127,138
"CWA","OO",162,0,52,0,25,239
"DAB","B6",101,0,4,0,198,303
"DAB","DL",33,0,53,0,168,254
"DAL","DL",62,69,61,0,203,395
"DAL","VX",851,538,3107,0,473,4969
"DAL","WN",9572,1543,5821,0,8841,25777
"DAY","AA",19,0,0,0,126,145
"DAY","DL",377,0,10,0,10,397
"DAY","OO",1320,20,239,0,577,2156
"DAY","WN",3,0,47,0,66,116
"DCA","AA",3094,542,3422,0,4393,11451
"DCA","AS",102,57,672,0,177,1008
"DCA","B6",3287,0,1428,0,2813,7528
"DCA","DL",1581,0,454,0,407,2442
"DCA","EV",546,0,4858,0,2692,8096
"DCA","F9",253,0,252,0,216,721
"DCA","OO",546,0,661,0,324,1531
"DCA","UA",474,0,554,0,462,1490
"DCA","VX",288,163,542,0,94,1087
"DCA","WN",723,205,669,0,1807,3404
"DEN","AA",1581,82,1740,0,1839,5242
"DEN","AS",96,66,586,0,732,1480
"DEN","B6",211,54,190,0,914,1369
"DEN","DL",3391,64,823,0,843,5121
"DEN","F9",3631,75,4256,0,4557,12519
"DEN","NK",867,41,2143,0,718,3769
"DEN","OO",8856,2455,9643,50,7879,28883
"DEN","UA",10774,3487,19069,0,15922,49252
"DEN","VX",209,134,895,13,166,1417
"DEN","WN",9998,1654,13773,0,16301,41726
"DFW","AA",36496,3253,22947,9,22832,85537
"DFW","AS",68,0,196,0,421,685
"DFW","B6",425,0,148,0,265,838
"DFW","DL",244,91,90,0,240,665
"DFW","EV",7777,0,1391,0,3350,12518
"DFW","F9",26,0,52,0,199,277
"DFW","NK",452,0,1226,0,532,2210
"DFW","OO",2697,29,1937,0,1183,5846
"DFW","UA",1166,0,1248,0,1524,3938
"DHN","EV",771,0,72,0,327,1170
"DLH","OO",0,13,84,0,235,332
"DRO","EV",13,0,11,0,143,167
"DRO","OO",845,11,142,0,74,1072
"DSM","AA",398,0,113,0,55,566
"DSM","DL",146,0,72,0,92,310
"DSM","EV",628,82,168,0,31,909
"DSM","F9",296,0,111,0,151,558
"DSM","OO",375,15,239,0,642,1271
"DSM","UA",595,49,170,0,35,849
"DSM","WN",26,2,136,0,64,228
"DTW","AA",2008,47,682,0,423,3160
"DTW","AS",6,0,112,0,0,118
"DTW","B6",167,54,144,117,414,896
"DTW","DL",7646,1640,9298,19,3207,21810
"DTW","EV",5667,0,626,0,2384,8677
"DTW","F9",328,0,32,0,178,538
"DTW","NK",3679,112,2978,8,1836,8613
"DTW","OO",9127,2242,1830,0,6440,19639
"DTW","UA",280,0,528,0,329,1137
"DTW","WN",507,108,721,0,668,2004
"DVL","OO",961,127,67,0,305,1460
"EAU","OO",294,0,611,0,188,1093
"ECP","DL",48,0,60,0,331,439
"ECP","EV",226,0,856,0,368,1450
"ECP","WN",245,69,25,0,237,576
"EGE","AA",1023,178,476,0,4287,5964
"EGE","DL",0,8,3,0,4,15
"EGE","OO",0,0,0,0,37,37
"EGE","UA",43,0,264,0,1162,1469
"EKO","OO",715,0,88,4,66,873
"ELM","EV",3,0,7,0,10,20
"ELP","AA",331,27,65,0,428,851
"ELP","DL",51,0,29,0,25,105
"ELP","EV",35,0,66,0,272,373
"ELP","OO",119,0,94,0,32,245
"ELP","WN",430,114,573,0,1897,3014
"ERI","EV",346,0,73,0,44,463
"ERI","OO",242,0,104,0,278,624
"ESC","OO",197,0,72,0,294,563
"EUG","OO",209,0,549,0,1020,1778
"EUG","UA",559,0,2076,0,468,3103
"EVV","DL",0,0,17,0,0,17
"EVV","EV",185,0,518,0,282,985
"EVV","OO",0,0,37,0,32,69
"EWN","EV",681,0,29,0,80,790
"EWR","AA",1596,487,1179,2,3028,6292
"EWR","AS",74,6,504,0,1205,1789
"EWR","B6",3437,53,1312,7,7499,12308
"EWR","DL",932,87,483,0,1733,3235
"EWR","EV",11395,300,6041,0,11369,29105
"EWR","NK",43,0,1929,0,64,2036
"EWR","OO",897,0,148,0,707,1752
"EWR","UA",16883,4083,12351,33,22745,56095
"EWR","VX",425,768,2973,0,469,4635
"EWR","WN",447,146,973,0,1488,3054
"EYW","DL",21,0,0,0,519,540
"EYW","EV",1195,0,24,0,941,2160
"FAI","AS",185,52,402,0,624,1263
"FAR","DL",154,6,100,0,0,260
"FAR","EV",1842,15,52,0,143,2052
"FAR","OO",0,0,221,0,164,385
"FAT","AA",93,0,7,0,485,585
"FAT","OO",3669,196,2577,0,3291,9733
"FAY","DL",104,0,15,0,24,143
"FAY","EV",0,0,17,0,479,496
"FCA","DL",0,170,75,0,0,245
"FCA","OO",1541,15,344,0,518,2418
"FLG","OO",0,0,71,0,44,115
"FLL","AA",760,0,853,0,1586,3199
"FLL","AS",330,98,202,0,91,721
"FLL","B6",12972,528,8428,101,10390,32419
"FLL","DL",941,6,1437,0,1982,4366
"FLL","F9",79,0,34,0,137,250
"FLL","NK",3774,33,5318,102,2121,11348
"FLL","UA",1187,0,2167,0,2331,5685
"FLL","VX",1080,353,2100,0,792,4325
"FLL","WN",3276,22,1296,15,6322,10931
"FNT","DL",263,0,0,0,0,263
"FNT","EV",0,119,77,0,332,528
"FNT","OO",614,0,89,0,481,1184
"FNT","WN",25,120,21,0,277,443
"FSD","DL",0,267,15,0,0,282
"FSD","EV",323,0,152,0,409,884
"FSD","OO",387,1,210,0,436,1034
"FSD","UA",0,0,192,0,0,192
"FSM","EV",44,0,56,0,441,541
"FWA","EV",0,0,15,0,0,15
"FWA","OO",3012,12,254,0,2179,5457
"GCC","OO",276,0,190,0,152,618
"GCK","EV",78,0,46,0,29,153
"GEG","AA",41,0,83,0,0,124
"GEG","AS",218,124,565,0,534,1441
"GEG","DL",127,127,132,0,171,557
"GEG","OO",1593,553,566,0,1422,4134
"GEG","UA",584,0,269,0,45,898
"GEG","WN",98,18,430,0,610,1156
"GFK","OO",322,0,16,0,240,578
"GJT","OO",312,18,84,0,411,825
"GNV","DL",617,0,71,0,15,703
"GNV","EV",699,0,291,0,1368,2358
"GPT","DL",31,0,146,0,225,402
"GPT","EV",383,0,236,0,194,813
"GRB","DL",0,14,57,0,0,71
"GRB","EV",987,0,308,0,298,1593
"GRB","OO",271,41,386,0,1171,1869
"GRI","EV",30,0,38,0,23,91
"GRK","EV",419,26,420,0,298,1163
"GRR","DL",852,160,76,0,518,1606
"GRR","EV",1413,315,709,0,681,3118
"GRR","OO",18,0,425,0,722,1165
"GRR","UA",203,0,125,0,228,556
"GRR","WN",211,227,376,0,211,1025
"GSO","DL",652,0,67,0,62,781
"GSO","EV",652,0,782,0,656,2090
"GSP","DL",1095,0,227,0,1,1323
"GSP","EV",541,0,398,0,588,1527
"GSP","OO",18,0,42,0,13,73
"GSP","WN",24,0,223,0,161,408
"GTF","OO",37,0,106,0,251,394
"GTR","EV",182,0,151,0,357,690
"GUC","AA",0,0,9,0,639,648
"GUM","UA",299,0,11,0,0,310
"HDN","AA",16,0,102,0,201,319
"HDN","DL",447,27,67,0,354,895
"HDN","OO",189,2,638,0,679,1508
"HDN","UA",170,26,20,0,79,295
"HIB","OO",366,0,79,22,183,650
"HLN","OO",500,13,151,0,24,688
"HNL","AA",939,0,177,0,442,1558
"HNL","AS",531,4,201,0,1290,2026
"HNL","DL",392,0,142,0,757,1291
"HNL","HA",8888,1194,620,0,10586,21288
"HNL","UA",1734,209,204,0,1851,3998
"HNL","VX",55,0,0,0,18,73
"HOB","EV",9,41,0,0,105,155
"HOU","B6",109,15,191,0,457,772
"HOU","DL",536,2,40,0,240,818
"HOU","EV",10,0,6,0,121,137
"HOU","WN",8426,1557,5673,0,8461,24117
"HPN","B6",2152,70,672,4,2074,4972
"HPN","EV",533,0,103,0,963,1599
"HRL","EV",5,0,21,0,95,121
"HRL","WN",306,102,237,0,431,1076
"HSV","DL",253,53,23,0,2,331
"HSV","EV",63,0,145,0,124,332
"HYS","OO",49,0,30,0,125,204
"IAD","AA",562,184,332,0,1201,2279
"IAD","AS",0,0,116,0,120,236
"IAD","B6",282,0,389,0,462,1133
"IAD","DL",1207,0,117,0,481,1805
"IAD","F9",3,0,22,0,178,203
"IAD","OO",30,0,0,0,0,30
"IAD","UA",5110,474,6386,0,5175,17145
"IAD","VX",48,448,1788,0,89,2373
"IAD","WN",11,0,361,0,219,591
"IAG","NK",91,0,1273,0,141,1505
"IAH","AA",1657,128,720,0,3623,6128
"IAH","AS",5,0,92,0,208,305
"IAH","DL",288,0,144,0,318,750
"IAH","EV",10508,1567,5638,0,7209,24922
"IAH","F9",108,0,135,0,295,538
"IAH","NK",1051,192,1360,0,894,3497
"IAH","OO",3703,323,970,0,3037,8033
"IAH","UA",11401,1831,14410,0,11458,39100
"ICT","AA",15,0,0,0,0,15
"ICT","EV",175,0,365,0,575,1115
"ICT","OO",589,0,48,0,863,1500
"ICT","UA",113,0,0,0,171,284
"ICT","WN",73,0,19,0,44,136
"IDA","OO",808,0,400,0,542,1750
"IFP","OO",20,0,102,0,399,521
"ILM","AA",0,0,87,0,113,200
"ILM","EV",358,0,39,0,259,656
"ILM","OO",1409,0,25,0,270,1704
"IMT","OO",1131,0,56,0,259,1446
"IND","AA",621,0,397,0,981,1999
"IND","DL",242,0,269,0,188,699
"IND","EV",584,61,831,0,502,1978
"IND","F9",40,0,60,0,113,213
"IND","OO",0,229,32,0,379,640
"IND","UA",321,0,48,0,195,564
"IND","WN",667,282,1124,0,1927,4000
"INL","OO",214,0,67,0,182,463
"ISN","OO",954,0,18,0,18,990
"ISP","WN",801,391,454,0,622,2268
"ITH","OO",183,0,134,0,313,630
"ITO","HA",596,487,265,0,3428,4776
"ITO","UA",0,0,0,0,58,58
"JAC","AA",81,0,99,0,1780,1960
"JAC","DL",640,213,379,0,924,2156
"JAC","OO",1451,65,1894,0,1166,4576
"JAC","UA",278,1421,1058,0,1913,4670
"JAN","DL",250,0,65,0,130,445
"JAN","EV",23,83,1236,0,385,1727
"JAX","AA",176,0,186,0,427,789
"JAX","B6",758,64,1042,0,1008,2872
"JAX","DL",778,0,240,0,325,1343
"JAX","EV",274,0,0,0,0,274
"JAX","UA",1628,0,577,0,605,2810
"JAX","WN",503,45,207,0,301,1056
"JFK","AA",6448,1324,9888,44,3298,21002
"JFK","AS",68,5,235,0,329,637
"JFK","B6",13103,3519,10570,102,11666,38960
"JFK","DL",5921,6964,10108,0,3933,26926
"JFK","HA",131,916,0,0,0,1047
"JFK","VX",778,1770,3193,12,397,6150
"JMS","OO",155,18,45,0,1473,1691
"JNU","AS",1441,850,485,0,993,3769
"KOA","AA",1620,0,38,0,263,1921
"KOA","AS",659,0,60,66,602,1387
"KOA","DL",89,0,25,0,143,257
"KOA","HA",685,537,313,10,3772,5317
"KOA","UA",74,0,12,0,1425,1511
"KTN","AS",313,211,217,0,231,972
"LAN","EV",4,0,73,0,421,498
"LAN","OO",1395,0,96,0,1342,2833
"LAR","OO",8,0,64,0,32,104
"LAS","AA",2380,0,2210,0,3431,8021
"LAS","AS",1020,5,538,40,1474,3077
"LAS","B6",1961,32,1432,7,5480,8912
"LAS","DL",1778,196,1725,0,2032,5731
"LAS","F9",828,0,661,0,1001,2490
"LAS","HA",789,66,0,0,106,961
"LAS","NK",1549,0,4046,0,1580,7175
"LAS","OO",0,0,327,0,362,689
"LAS","UA",1892,16,5477,0,1656,9041
"LAS","VX",676,21,4410,0,2719,7826
"LAS","WN",11078,1479,9432,2,20409,42400
"LAX","AA",8483,238,5276,0,7882,21879
"LAX","AS",2692,143,1941,0,5007,9783
"LAX","B6",2023,64,1817,0,3744,7648
"LAX","DL",13195,1670,4543,19,16399,35826
"LAX","F9",578,0,199,0,532,1309
"LAX","HA",2166,53,17,21,75,2332
"LAX","NK",1880,0,6551,46,2160,10637
"LAX","OO",19184,1931,7055,0,38597,66767
"LAX","UA",7197,98,6010,0,9981,23286
"LAX","VX",2447,1483,9691,88,6787,20496
"LAX","WN",11115,1007,7714,27,37899,57762
"LBB","AA",175,0,0,0,0,175
"LBB","EV",30,52,76,0,205,363
"LBB","OO",0,0,60,0,21,81
"LBB","WN",205,0,40,0,483,728
"LBE","NK",50,0,129,0,181,360
"LCH","EV",659,0,251,0,414,1324
"LEX","DL",172,0,47,0,242,461
"LEX","EV",2083,0,1492,0,1085,4660
"LEX","OO",1743,75,220,0,2270,4308
"LFT","DL",50,0,3,0,0,53
"LFT","EV",514,54,2170,0,1123,3861
"LGA","AA",3117,671,2385,0,4772,10945
"LGA","B6",2408,31,839,0,2846,6124
"LGA","DL",5785,5645,2255,0,9195,22880
"LGA","EV",5869,0,1695,0,7805,15369
"LGA","F9",39,0,117,0,804,960
"LGA","NK",247,0,1912,0,341,2500
"LGA","OO",0,0,308,0,200,508
"LGA","UA",2125,927,709,0,2256,6017
"LGA","VX",40,0,169,0,292,501
"LGA","WN",1392,356,1909,15,4643,8315
"LGB","B6",4030,150,2354,73,6679,13286
"LGB","OO",172,35,37,0,46,290
"LGB","WN",829,0,123,0,877,1829
"LIH","AA",186,0,106,0,26,318
"LIH","AS",216,93,101,0,684,1094
"LIH","DL",136,0,24,0,413,573
"LIH","HA",680,750,132,0,5436,6998
"LIH","UA",452,0,21,0,741,1214
"LIT","DL",101,0,79,0,118,298
"LIT","EV",540,8,339,0,1599,2486
"LIT","OO",110,0,5,0,11,126
"LIT","WN",226,0,245,0,734,1205
"LNK","EV",501,0,0,0,43,544
"LNK","OO",21,3,123,0,451,598
"LRD","EV",658,0,245,0,957,1860
"LSE","OO",764,33,183,0,131,1111
"LWS","OO",0,859,64,0,18,941
"MAF","EV",3,56,325,0,626,1010
"MAF","OO",36,0,262,0,320,618
"MAF","WN",62,116,104,0,719,1001
"MBS","OO",432,828,58,0,656,1974
"MCI","AA",406,0,128,0,272,806
"MCI","AS",38,0,131,0,112,281
"MCI","DL",1345,0,165,0,693,2203
"MCI","EV",191,0,104,0,599,894
"MCI","F9",20,0,162,0,501,683
"MCI","NK",240,0,1015,0,708,1963
"MCI","OO",75,15,913,0,504,1507
"MCI","UA",248,0,345,0,775,1368
"MCI","WN",2691,229,2563,0,4009,9492
"MCO","AA",2790,104,1981,104,5645,10624
"MCO","AS",56,124,244,0,177,601
"MCO","B6",7401,27,6218,67,7357,21070
"MCO","DL",3451,57,3865,0,2361,9734
"MCO","EV",33,0,0,0,113,146
"MCO","F9",2554,70,2608,0,3516,8748
"MCO","NK",1083,27,2816,0,2903,6829
"MCO","UA",2183,109,3958,0,1687,7937
"MCO","VX",5,89,502,0,152,748
"MCO","WN",3819,577,1778,9,7344,13527
"MDT","AA",24,0,15,0,0,39
"MDT","DL",0,0,89,0,0,89
"MDT","EV",121,0,30,0,0,151
"MDT","OO",13,0,93,0,618,724
"MDW","DL",64,45,41,0,133,283
"MDW","EV",277,0,0,0,439,716
"MDW","OO",40,0,6,0,162,208
"MDW","WN",9490,2966,8723,0,13499,34678
"MEI","EV",772,0,112,0,505,1389
"MEM","AA",913,0,251,0,384,1548
"MEM","DL",168,39,167,0,307,681
"MEM","EV",271,0,1402,0,733,2406
"MEM","F9",24,0,19,0,58,101
"MEM","OO",124,0,0,0,161,285
"MEM","UA",139,0,173,0,507,819
"MEM","WN",39,18,109,0,491,657
"MFE","AA",166,0,25,0,145,336
"MFE","EV",0,0,0,0,46,46
"MFE","UA",162,257,85,0,0,504
"MFR","OO",823,0,1280,0,520,2623
"MGM","EV",894,0,122,0,716,1732
"MHT","DL",292,26,27,0,0,345
"MHT","EV",1121,0,2706,0,510,4337
"MHT","WN",579,124,388,0,326,1417
"MIA","AA",18631,616,10272,34,11339,40892
"MIA","DL",2698,11,1778,0,2313,6800
"MIA","F9",286,0,827,0,743,1856
"MIA","OO",0,0,0,0,44,44
"MIA","UA",2099,6,3531,0,855,6491
"MKE","AA",61,19,150,0,194,424
"MKE","DL",572,0,136,0,163,871
"MKE","EV",160,0,1293,0,1012,2465
"MKE","F9",142,0,290,0,256,688
"MKE","OO",1507,23,716,0,1221,3467
"MKE","UA",538,0,311,0,287,1136
"MKE","WN",474,586,1671,0,1971,4702
"MKG","OO",66,0,210,0,274,550
"MLB","DL",4,0,61,0,223,288
"MLI","EV",446,0,42,0,315,803
"MLI","OO",144,178,57,0,259,638
"MLU","EV",1497,0,381,0,1547,3425
"MMH","OO",58,0,152,0,283,493
"MOB","DL",0,0,106,0,0,106
"MOB","EV",2394,0,414,0,1171,3979
"MOT","OO",1746,0,64,0,147,1957
"MQT","OO",967,0,135,0,253,1355
"MRY","OO",587,0,1084,0,1991,3662
"MSN","DL",286,196,196,0,246,924
"MSN","EV",171,0,367,0,217,755
"MSN","F9",23,0,37,0,21,81
"MSN","OO",3251,2,329,0,751,4333
"MSN","UA",149,0,333,0,325,807
"MSO","DL",33,295,75,0,213,616
"MSO","OO",1521,434,20,0,217,2192
"MSP","AA",817,199,871,0,1239,3126
"MSP","AS",168,0,245,0,74,487
"MSP","DL",7467,147,10280,0,2877,20771
"MSP","EV",695,0,435,0,966,2096
"MSP","F9",56,0,74,0,129,259
"MSP","NK",635,0,1613,0,1230,3478
"MSP","OO",6066,934,3505,0,3448,13953
"MSP","UA",461,0,2020,0,533,3014
"MSP","WN",529,194,937,0,1359,3019
"MSY","AA",528,28,404,0,1113,2073
"MSY","AS",20,0,128,0,263,411
"MSY","B6",889,0,533,0,707,2129
"MSY","DL",1012,85,1596,0,1571,4264
"MSY","EV",1,0,38,0,0,39
"MSY","F9",1,0,128,0,281,410
"MSY","NK",386,0,1578,0,685,2649
"MSY","UA",683,5,1349,0,2682,4719
"MSY","WN",1475,378,2094,0,3105,7052
"MTJ","AA",134,0,18,0,89,241
"MTJ","DL",40,0,4,0,0,44
"MTJ","EV",5,0,4,0,119,128
"MTJ","OO",88,0,250,0,139,477
"MTJ","UA",108,0,86,0,223,417
"MYR","DL",15,0,6,0,124,145
"MYR","EV",249,0,15,0,343,607
"MYR","NK",293,35,1018,0,1415,2761
"OAJ","DL",0,19,0,0,3,22
"OAJ","EV",247,0,29,0,245,521
"OAK","AA",44,0,3,0,138,185
"OAK","AS",77,30,853,0,413,1373
"OAK","B6",474,227,236,0,1251,2188
"OAK","DL",36,92,20,0,107,255
"OAK","HA",1878,46,4,0,0,1928
"OAK","NK",257,19,1438,0,575,2289
"OAK","OO",544,0,40,0,0,584
"OAK","WN",7574,1093,5530,18,14927,29142
"OGG","AA",974,0,28,0,314,1316
"OGG","AS",907,0,209,0,1682,2798
"OGG","DL",436,0,114,0,311,861
"OGG","HA",2922,1266,652,10,9699,14549
"OGG","UA",117,120,50,0,461,748
"OGG","VX",54,8,66,0,600,728
"OKC","AA",1349,0,119,0,200,1668
"OKC","DL",20,0,8,0,215,243
"OKC","EV",169,0,3,0,89,261
"OKC","OO",345,0,1396,0,1522,3263
"OKC","UA",211,0,194,0,25,430
"OKC","WN",462,132,314,0,518,1426
"OMA","AA",188,20,691,0,54,953
"OMA","AS",0,0,67,0,208,275
"OMA","DL",24,0,335,0,212,571
"OMA","EV",905,27,697,0,1063,2692
"OMA","F9",380,0,110,0,98,588
"OMA","OO",56,58,644,0,226,984
"OMA","UA",899,0,283,0,68,1250
"OMA","WN",582,87,829,0,943,2441
"OME","AS",9,33,37,0,343,422
"ONT","AA",521,0,41,0,420,982
"ONT","AS",56,0,138,0,604,798
"ONT","DL",21,0,0,0,0,21
"ONT","OO",201,462,3383,0,2658,6704
"ONT","UA",116,0,38,0,135,289
"ONT","WN",1063,86,473,0,4616,6238
"ORD","AA",12259,1656,13261,34,7887,35097
"ORD","AS",48,0,455,0,686,1189
"ORD","B6",457,0,329,0,1534,2320
"ORD","DL",2673,59,196,0,797,3725
"ORD","EV",9761,1086,4993,0,8313,24153
"ORD","F9",396,66,1845,0,1011,3318
"ORD","NK",1948,703,3030,11,2192,7884
"ORD","OO",19869,2909,8615,3,15388,46784
"ORD","UA",16390,1868,18776,0,18805,55839
"ORD","VX",96,91,1485,0,243,1915
"ORF","AA",821,0,65,0,95,981
"ORF","DL",354,0,27,0,86,467
"ORF","EV",49,0,73,0,458,580
"ORF","OO",1306,0,54,0,0,1360
"ORF","WN",9,0,33,0,245,287
"ORH","B6",83,6,12,0,335,436
"OTH","OO",0,0,95,0,163,258
"OTZ","AS",221,116,3,0,229,569
"PAH","OO",60,0,320,0,117,497
"PBG","NK",91,0,258,0,169,518
"PBI","AA",183,377,375,0,1626,2561
"PBI","B6",2928,104,4350,40,5284,12706
"PBI","DL",1368,6,1645,48,1969,5036
"PBI","EV",2,0,11,0,4,17
"PBI","F9",461,0,181,0,415,1057
"PBI","NK",179,0,405,0,371,955
"PBI","UA",710,28,2321,0,392,3451
"PBI","WN",734,99,293,0,1133,2259
"PDX","AA",1051,0,245,0,285,1581
"PDX","AS",2203,473,6616,0,2080,11372
"PDX","B6",291,0,254,0,406,951
"PDX","DL",390,404,1275,0,2148,4217
"PDX","F9",193,4,93,0,333,623
"PDX","HA",133,94,0,0,0,227
"PDX","NK",32,0,819,0,87,938
"PDX","OO",2329,181,3023,0,7627,13160
"PDX","UA",1331,338,4405,0,2858,8932
"PDX","VX",83,119,1384,0,158,1744
"PDX","WN",1632,33,1539,11,3401,6616
"PGD","F9",281,0,58,0,438,777
"PHF","DL",81,0,0,0,0,81
"PHF","EV",54,0,0,0,89,143
"PHL","AA",8289,566,7341,4,6951,23151
"PHL","AS",28,0,112,0,238,378
"PHL","B6",209,12,200,0,882,1303
"PHL","DL",638,39,251,0,688,1616
"PHL","F9",302,0,409,0,1389,2100
"PHL","NK",916,0,737,0,47,1700
"PHL","OO",79,0,0,0,0,79
"PHL","UA",285,35,1667,0,910,2897
"PHL","WN",433,96,888,0,1299,2716
"PHX","AA",8171,27,8517,54,4776,21545
"PHX","AS",514,0,1225,0,658,2397
"PHX","B6",180,0,127,0,712,1019
"PHX","DL",1115,0,189,0,1032,2336
"PHX","F9",1254,0,542,0,1680,3476
"PHX","HA",600,0,0,0,0,600
"PHX","NK",541,0,583,0,60,1184
"PHX","OO",3358,908,3781,25,4918,12990
"PHX","UA",1833,602,1351,0,1411,5197
"PHX","WN",7372,1002,8675,4,14691,31744
"PIA","EV",321,0,56,0,407,784
"PIA","OO",606,76,91,332,333,1438
"PIB","EV",162,0,340,0,206,708
"PIH","OO",393,0,228,0,146,767
"PIT","AA",424,0,769,0,677,1870
"PIT","B6",255,33,112,0,260,660
"PIT","DL",157,0,184,0,314,655
"PIT","EV",225,0,167,0,371,763
"PIT","F9",414,0,245,0,192,851
"PIT","OO",399,21,208,0,637,1265
"PIT","UA",96,0,348,0,298,742
"PIT","WN",1062,218,1242,0,1522,4044
"PLN","OO",70,0,64,0,151,285
"PNS","DL",173,0,157,0,126,456
"PNS","EV",0,0,262,0,517,779
"PNS","WN",105,0,28,0,226,359
"PPG","HA",54,0,0,0,66,120
"PSC","OO",1901,42,690,0,850,3483
"PSE","B6",8,0,82,0,93,183
"PSG","AS",0,0,8,0,185,193
"PSP","AA",35,0,61,0,403,499
"PSP","AS",221,9,1100,0,932,2262
"PSP","B6",78,0,46,0,282,406
"PSP","DL",11,0,0,0,93,104
"PSP","OO",3887,0,2797,18,4217,10919
"PSP","UA",140,0,473,0,201,814
"PSP","VX",25,24,548,0,345,942
"PVD","AA",130,8,439,0,172,749
"PVD","B6",189,0,40,0,369,598
"PVD","DL",555,18,71,0,227,871
"PVD","EV",125,0,498,0,707,1330
"PVD","OO",62,12,69,0,42,185
"PVD","WN",909,558,764,0,786,3017
"PWM","AA",54,77,66,0,191,388
"PWM","B6",64,160,208,0,281,713
"PWM","DL",0,364,16,0,0,380
"PWM","EV",35,105,1117,0,778,2035
"PWM","WN",0,149,279,0,30,458
"RAP","OO",874,0,221,0,329,1424
"RDD","OO",28,0,493,0,689,1210
"RDM","OO",325,907,3012,0,1428,5672
"RDU","AA",5312,0,1610,14,2388,9324
"RDU","AS",18,0,139,0,65,222
"RDU","B6",1490,0,827,0,1468,3785
"RDU","DL",721,12,323,0,506,1562
"RDU","EV",246,0,287,0,515,1048
"RDU","F9",427,0,23,0,620,1070
"RDU","OO",125,0,237,0,166,528
"RDU","UA",964,0,1803,0,507,3274
"RDU","WN",843,203,627,0,1918,3591
"RHI","OO",0,0,100,0,0,100
"RIC","AA",324,0,219,0,413,956
"RIC","B6",249,0,284,0,1355,1888
"RIC","DL",257,0,106,0,46,409
"RIC","EV",3568,0,1538,0,1281,6387
"RIC","OO",1192,0,121,0,247,1560
"RIC","WN",24,0,118,0,71,213
"RKS","OO",905,0,24,0,11,940
"RNO","AA",104,4,99,0,137,344
"RNO","B6",185,106,69,0,512,872
"RNO","DL",204,0,42,0,90,336
"RNO","OO",3489,0,1477,0,1558,6524
"RNO","UA",137,0,275,0,694,1106
"RNO","WN",765,232,964,0,2219,4180
"ROA","DL",734,0,0,0,0,734
"ROA","EV",120,0,193,0,715,1028
"ROC","AA",240,0,2,0,25,267
"ROC","B6",210,0,424,0,360,994
"ROC","DL",475,7,81,0,0,563
"ROC","EV",44,42,316,0,103,505
"ROC","OO",3,0,76,0,681,760
"ROC","UA",131,0,70,0,23,224
"ROC","WN",7,0,148,0,263,418
"ROW","OO",334,0,16,0,61,411
"RST","EV",116,0,13,0,571,700
"RST","OO",359,1171,166,0,574,2270
"RSW","AA",268,18,586,0,529,1401
"RSW","B6",1424,11,3062,0,2640,7137
"RSW","DL",936,0,559,0,921,2416
"RSW","F9",193,0,76,0,207,476
"RSW","NK",730,0,1643,0,1592,3965
"RSW","OO",0,0,0,0,125,125
"RSW","UA",265,226,1215,0,1151,2857
"RSW","WN",1198,13,437,0,2860,4508
"SAF","EV",592,0,104,0,398,1094
"SAF","OO",0,0,80,0,0,80
"SAN","AA",1452,1570,726,0,2431,6179
"SAN","AS",626,362,1977,33,3019,6017
"SAN","B6",290,49,422,0,756,1517
"SAN","DL",664,266,315,0,2285,3530
"SAN","F9",138,436,104,0,399,1077
"SAN","HA",129,263,31,0,0,423
"SAN","NK",128,0,442,0,182,752
"SAN","OO",1228,209,1711,0,8341,11489
"SAN","UA",1090,304,5562,0,5334,12290
"SAN","VX",208,124,3319,2,914,4567
"SAN","WN",5595,770,4066,0,18534,28965
"SAT","AA",873,697,442,0,683,2695
"SAT","AS",0,0,60,0,67,127
"SAT","DL",465,21,151,0,766,1403
"SAT","EV",0,0,0,0,47,47
"SAT","F9",1,0,20,0,129,150
"SAT","OO",828,0,1108,0,562,2498
"SAT","UA",185,0,523,0,662,1370
"SAT","WN",1854,247,2317,0,3220,7638
"SAV","B6",108,0,211,0,1015,1334
"SAV","DL",125,0,186,0,186,497
"SAV","EV",651,193,709,0,555,2108
"SAV","UA",69,0,41,0,0,110
"SBA","OO",1042,90,3202,0,4561,8895
"SBN","EV",66,0,36,0,63,165
"SBN","OO",1742,45,125,0,899,2811
"SBP","OO",1236,15,3172,4,2342,6769
"SCC","AS",38,66,62,0,421,587
"SCE","EV",251,328,77,0,91,747
"SCE","OO",980,0,19,0,93,1092
"SDF","AA",13,0,48,0,91,152
"SDF","DL",40,26,151,0,168,385
"SDF","EV",218,39,917,0,596,1770
"SDF","OO",3,18,72,0,261,354
"SDF","WN",295,0,204,0,326,825
"SEA","AA",2247,1069,1533,0,1163,6012
"SEA","AS",18704,3393,24733,28,5602,52460
"SEA","B6",974,77,632,0,1551,3234
"SEA","DL",2081,2100,3267,0,3458,10906
"SEA","F9",234,9,99,0,496,838
"SEA","HA",1190,460,43,0,0,1693
"SEA","NK",66,48,1462,0,239,1815
"SEA","OO",9804,2237,5194,14,12658,29907
"SEA","UA",1453,218,2233,0,2126,6030
"SEA","VX",227,37,3903,0,532,4699
"SEA","WN",1398,269,1418,0,3416,6501
"SFO","AA",5495,199,1409,0,6189,13292
"SFO","AS",920,188,1092,14,5327,7541
"SFO","B6",2409,191,1313,0,5551,9464
"SFO","DL",2134,177,694,0,3346,6351
"SFO","F9",1504,0,438,0,2099,4041
"SFO","HA",1363,77,60,0,0,1500
"SFO","OO",18260,1597,6848,0,30820,57525
"SFO","UA",19575,523,9857,0,32513,62468
"SFO","VX",2747,496,5689,28,15264,24224
"SFO","WN",2525,1075,3543,0,17053,24196
"SGF","EV",46,0,24,0,796,866
"SGF","OO",0,0,102,0,165,267
"SGU","OO",1609,0,356,0,338,2303
"SHV","DL",35,0,0,0,0,35
"SHV","EV",2366,302,611,0,808,4087
"SHV","OO",0,0,79,0,150,229
"SIT","AS",16,16,134,0,219,385
"SJC","AA",327,0,159,0,339,825
"SJC","AS",470,349,1274,0,880,2973
"SJC","B6",399,60,177,0,802,1438
"SJC","DL",2055,0,948,0,628,3631
"SJC","HA",400,62,0,0,0,462
"SJC","OO",234,334,310,0,2336,3214
"SJC","UA",814,0,121,0,260,1195
"SJC","WN",3284,867,4020,12,13652,21835
"SJU","AA",1327,0,900,0,1258,3485
"SJU","B6",2208,0,1238,25,4161,7632
"SJU","DL",66,0,153,0,145,364
"SJU","NK",26,0,145,0,242,413
"SJU","UA",480,8,446,0,2528,3462
"SJU","WN",319,0,110,0,199,628
"SLC","AA",1620,0,485,3,368,2476
"SLC","AS",808,0,896,6,28,1738
"SLC","B6",731,0,526,0,1884,3141
"SLC","DL",10079,1493,8178,18,4396,24164
"SLC","F9",102,2,84,0,579,767
"SLC","OO",6594,3069,6683,3,6263,22612
"SLC","UA",844,0,1344,0,852,3040
"SLC","WN",870,129,2447,0,4275,7721
"SMF","AA",521,0,240,0,544,1305
"SMF","AS",313,35,621,0,443,1412
"SMF","B6",114,0,128,0,840,1082
"SMF","DL",680,0,283,0,307,1270
"SMF","HA",149,0,0,0,0,149
"SMF","OO",2339,20,2840,0,4835,10034
"SMF","UA",1968,0,178,0,608,2754
"SMF","WN",2926,587,3876,0,8482,15871
"SNA","AA",1482,0,219,0,975,2676
"SNA","AS",441,207,397,2,1413,2460
"SNA","DL",1031,0,23,0,402,1456
"SNA","F9",11,0,156,0,88,255
"SNA","OO",58,0,873,0,709,1640
"SNA","UA",906,0,2831,0,2500,6237
"SNA","WN",2880,584,2634,8,8728,14834
"SPI","EV",29,0,40,0,91,160
"SPI","OO",1,0,37,0,223,261
"SPS","EV",717,0,56,0,212,985
"SRQ","B6",275,0,29,0,410,714
"SRQ","DL",730,0,31,0,249,1010
"SRQ","UA",32,0,384,0,203,619
"STL","AA",655,0,1048,0,2387,4090
"STL","AS",0,0,181,0,13,194
"STL","DL",295,0,106,0,440,841
"STL","EV",1385,0,1907,0,1282,4574
"STL","F9",380,0,429,0,302,1111
"STL","OO",1538,0,1181,0,560,3279
"STL","UA",16,0,4,0,79,99
"STL","WN",3370,860,3447,0,4898,12575
"STS","OO",21,0,5,0,19,45
"STT","AA",1471,0,394,0,1514,3379
"STT","B6",173,154,31,0,776,1134
"STT","DL",10,25,86,0,8,129
"STT","NK",79,0,165,0,66,310
"STT","UA",182,0,125,0,985,1292
"STX","AA",187,0,36,0,0,223
"STX","B6",0,0,0,0,242,242
"SUN","OO",55,100,512,0,778,1445
"SWF","B6",79,0,270,0,465,814
"SWF","OO",0,0,34,0,59,93
"SYR","AA",70,0,0,0,0,70
"SYR","B6",475,85,579,0,473,1612
"SYR","DL",11,51,8,0,37,107
"SYR","EV",0,0,16,0,18,34
"SYR","OO",11,0,342,0,367,720
"TLH","DL",54,7,35,0,161,257
"TLH","EV",353,0,26,0,582,961
"TPA","AA",2931,168,700,0,2854,6653
"TPA","AS",38,0,121,0,48,207
"TPA","B6",1114,0,1558,0,2347,5019
"TPA","DL",1751,0,1119,0,3119,5989
"TPA","F9",775,0,243,0,1100,2118
"TPA","NK",2205,147,992,0,1395,4739
"TPA","UA",1314,0,2183,0,2229,5726
"TPA","WN",2573,609,1827,12,5407,10428
"TRI","EV",408,0,15,0,720,1143
"TTN","F9",576,77,40,0,2527,3220
"TUL","AA",37,0,228,0,353,618
"TUL","DL",23,0,12,0,107,142
"TUL","EV",827,0,387,0,717,1931
"TUL","OO",839,0,24,0,132,995
"TUL","UA",185,0,3,0,92,280
"TUL","WN",199,0,285,0,338,822
"TUS","AA",1040,0,84,0,318,1442
"TUS","AS",7,0,27,0,21,55
"TUS","DL",318,0,0,0,16,334
"TUS","EV",225,0,0,0,25,250
"TUS","OO",1955,450,3784,14,2592,8795
"TUS","UA",10,0,0,0,100,110
"TUS","WN",680,375,1326,0,1852,4233
"TVC","EV",0,0,75,0,154,229
"TVC","OO",699,158,164,0,1487,2508
"TWF","OO",477,353,435,0,1508,2773
"TXK","EV",28,0,15,0,0,43
"TYR","EV",11,0,19,0,117,147
"TYS","DL",266,24,45,0,107,442
"TYS","EV",1439,104,616,0,1202,3361
"TYS","OO",1329,0,23,0,280,1632
"TYS","UA",0,0,213,0,0,213
"VLD","EV",694,0,194,0,266,1154
"VPS","DL",1660,0,30,0,35,1725
"VPS","EV",14,0,191,0,708,913
"WRG","AS",0,0,33,0,193,226
"XNA","DL",0,0,0,0,15,15
"XNA","EV",111,0,501,0,656,1268
"XNA","OO",911,0,201,0,963,2075
"YAK","AS",89,168,42,0,483,782
"YUM","OO",0,0,100,50,23,173
